0 0 0 0 0 0 0 0 0
0 0 X X 1 X X 0 0
0 X 1 1 X 1 1 X 0
0 B 2 2 B 2 2 B 0
0 0 3 3 B 3 3 0 0
0 0 X X B X X 0 0
0 0 1 1 X 1 1 0 0
0 B 2 2 0 2 2 B 0
0 X 3 3 0 3 3 X 0
0 0 X X 0 X X 0 0
0 0 0 0 0 0 0 0 0

